
================================================================================
Task 424/500: What is the chemical symbol for praseodymium?
================================================================================

╭───────────────────────────────────────────────────────────────────── New run ──────────────────────────────────────────────────────────────────────╮
│                                                                                                                                                    │
│ What is the chemical symbol for praseodymium?                                                                                                      │
│                                                                                                                                                    │
╰─ LiteLLMModel - ollama_chat/qwen3:1.7b ────────────────────────────────────────────────────────────────────────────────────────────────────────────╯
━━━━━━━━━━━━━━━━━━━━━━━━━━━━━━━━━━━━━━━━━━━━━━━━━━━━━━━━━━━━━━━━━━━━━━━ Step 1 ━━━━━━━━━━━━━━━━━━━━━━━━━━━━━━━━━━━━━━━━━━━━━━━━━━━━━━━━━━━━━━━━━━━━━━━
Output message of the LLM: ───────────────────────────────────────────────────────────────────────────────────────────────────────────────────────────
<think>                                                                                                                                               
Okay, the user is asking for the chemical symbol of praseodymium. Let me think about how to approach this.                                            
                                                                                                                                                      
First, I know that chemical symbols are usually abbreviations of the element's name. Praseodymium is a rare earth element. From what I remember, the  
symbols for elements are often derived from their Latin names. For example, iron is Fe, and silver is Ag. So praseodymium might be a variation of the 
Latin name.                                                                                                                                           
                                                                                                                                                      
Wait, the Latin name for praseodymium is "Praseodymium," which in Latin is "Praseodymium." The chemical symbol is Pr. But I should verify this. Maybe 
there's a different symbol. Let me check.                                                                                                             
                                                                                                                                                      
Since I can't perform internet searches right now, I need to rely on my existing knowledge. I recall that the symbols for the elements are as follows:
                                                                                                                                                      
- Beryllium: Be                                                                                                                                       
- Boron: B                                                                                                                                            
- Carbon: C                                                                                                                                           
- Nitrogen: N                                                                                                                                         
- Oxygen: O                                                                                                                                           
- Fluorine: F                                                                                                                                         
- Neon: Ne                                                                                                                                            
- Sodium: Na                                                                                                                                          
- Magnesium: Mg                                                                                                                                       
- Aluminum: Al                                                                                                                                        
- Silicon: Si                                                                                                                                         
- Phosphorus: P                                                                                                                                       
- Sulfur: S                                                                                                                                           
- Chlorine: Cl                                                                                                                                        
- Argon: Ar                                                                                                                                           
- Potassium: K                                                                                                                                        
- Calcium: Ca                                                                                                                                         
- Scandium: Sc                                                                                                                                        
- Titanium: Ti                                                                                                                                        
- Vanadium: V                                                                                                                                         
- Chromium: Cr                                                                                                                                        
- Manganese: Mn                                                                                                                                       
- Iron: Fe                                                                                                                                            
- Cobalt: Co                                                                                                                                          
- Nickel: Ni                                                                                                                                          
- Copper: Cu                                                                                                                                          
- Zinc: Zn                                                                                                                                            
- Gallium: Ga                                                                                                                                         
- Germanium: Ge                                                                                                                                       
- Arsenic: As                                                                                                                                         
- Selenium: Se                                                                                                                                        
- Bromine: Br                                                                                                                                         
- Krypton: Kr                                                                                                                                         
- Rubidium: Rb                                                                                                                                        
- Strontium: Sr                                                                                                                                       
- Yttrium: Y                                                                                                                                          
- Zirconium: Zr                                                                                                                                       
- Niobium: Nb                                                                                                                                         
- Molybdenum: Mo                                                                                                                                      
- Technetium: Tc                                                                                                                                      
- Ruthenium: Ru                                                                                                                                       
- Rhodium: Rh                                                                                                                                         
- Palladium: Pd                                                                                                                                       
- Silver: Ag                                                                                                                                          
- Cadmium: Cd                                                                                                                                         
- Indium: In                                                                                                                                          
- Tin: Sn                                                                                                                                             
- Antimony: Sb                                                                                                                                        
- Tellurium: Te                                                                                                                                       
- Iodine: I                                                                                                                                           
- Xenon: Xe                                                                                                                                           
- Cesium: Cs                                                                                                                                          
- Barium: Ba                                                                                                                                          
- Lanthanum: La                                                                                                                                       
- Cerium: Ce                                                                                                                                          
- Praseodymium: Pr                                                                                                                                    
- Neodymium: Nd                                                                                                                                       
- Promethium: Pm                                                                                                                                      
- Samarium: Sm                                                                                                                                        
- Europium: Eu                                                                                                                                        
- Gadolinium: Gd                                                                                                                                      
- Terbium: Tb                                                                                                                                         
- Dysprosium: Dy                                                                                                                                      
- Holmium: Ho                                                                                                                                         
- Erbium: Er                                                                                                                                          
- Thulium: Tm                                                                                                                                         
- Ytterbium: Yb                                                                                                                                       
- Lutetium: Lu                                                                                                                                        
                                                                                                                                                      
So, praseodymium's symbol is Pr. But I should make sure. Sometimes elements have symbols that are different. For example, lutetium is Lu, which is a  
variation of the Latin name for the element. So, praseodymium is Pr.                                                                                  
                                                                                                                                                      
Therefore, the answer should be Pr.                                                                                                                   
</think>                                                                                                                                              
                                                                                                                                                      
Code:                                                                                                                                                 
```py                                                                                                                                                 
final_answer("Pr")                                                                                                                                    
```                                                                                                                                                   
 ─ Executing parsed code: ─────────────────────────────────────────────────────────────────────────────────────────────────────────────────────────── 
  final_answer("Pr")                                                                                                                                  
 ──────────────────────────────────────────────────────────────────────────────────────────────────────────────────────────────────────────────────── 
Out - Final answer: Pr
[Step 1: Duration 32.57 seconds| Input tokens: 2,101 | Output tokens: 698]

Output:
Pr

Task 424 complete.
------------------------------------------------------------
